wwwwwwwwwwwwwww
ws000000000000w
w000000wwwww00w
w000000000w000w
w0www00000w000w
w00w000000w000w
w00w0000000000w
w0000w00000000w
w0000w0wwww000w
w0000w0000w000w
w0000w00000000w
w0000000000000w
w00000wwwww000w
w000000000000gw
wwwwwwwwwwwwwww
